worldSize;9;9;

//Final
room;4;8;
color;0;0;0;
goalDoor;2;

//Starting
room;4;7;
color;0;0;0;
goalDoor;2;
colorLock;2;255;0;0;
music;m_cyber-factory;
H;H;0;
h;H;1;
P;P;
o;B;0;0;0;0;
x;B;0;0;0;1;

//Crossways
room;4;6;
color;0;0;0;
goalDoor;1;
o;B;0;0;0;0;
c;B;0;0;0;1;
x;B;50;50;150;1;
b;B;0;0;0;2;
e;E;1;1;
k;K;50;50;150;1;
t;T;

//Start Blue Rooms
room;5;6;
color;0;0;80;
goalDoor;1;
music;m_cyber-factory;
t;T;
p;p;

room;6;6;
color;0;0;80;
goalDoor;3;
k;K;0;0;100;3;
x;B;0;0;100;1;
y;B;0;0;0;1;
o;B;0;0;0;0;

room;6;7;
color;0;0;80;
goalDoor;3;
music;m_the-boxer;
o;B;0;0;0;0;
x;B;0;0;0;1;
b;B;0;0;100;2;
t;T;

room;7;7;
color;0;0;120;
goalDoor;1;
lockOnEnter;
H;H;1;
o;B;0;0;0;0;
b;B;0;0;0;2;
k;K;0;0;100;0;
x;B;0;0;100;1;
p;p;

room;6;8;
color;0;0;80;
goalDoor;1;
music;m_cyber-factory;
o;B;0;0;100;0;
b;B;0;0;0;2;
A;A;2;1;
B;A;0;1;
C;A;1;2;
D;A;1;0;
x;B;0;0;100;1;
k;K;0;0;100;1;

room;7;8;
color;0;0;80;
goalDoor;1;
music;m_the-boxer;
o;B;0;0;100;0;
x;B;0;0;0;1;
k;K;0;0;0;1;
t;T;
P;P;

room;8;8;
color;0;0;80;
goalDoor;2;
e;E;
t;T;
x;B;0;0;80;1;
k;K;0;0;80;2;
A;t;1;7;
B;t;8;7;
C;t;8;0;
D;t;2;0;
E;t;5;5;

room;8;7;
color;0;0;80;
goalDoor;4;
o;B;0;0;100;0;
a;t;11;9;
b;t;11;6;
t;T;
A;A;2;1;
B;A;0;1;
x;B;50;50;150;1;
k;K;50;50;150;2;


room;8;6;
color;0;0;80;
goalDoor;2;
music;m_tekno-labs;
o;B;0;0;100;1;
A;A;2;1;
B;A;0;1;
C;A;1;2;
D;A;1;0;

room;8;5;
color;0;0;80;
goalDoor;4;
o;B;0;0;100;0;
t;T;
x;B;50;50;150;1;
k;K;50;50;150;2;
p;p;

//Blue Boss
room;8;4;
color;0;0;200;
goalDoor;0;
music;m_air-sharks;
onEnterDialogue;2;
colorLock;0;0;0;255;
o;B;0;0;0;0;
F;F;4000;
t;T;
B;X;

room;7;4;
color;0;0;80;
goalDoor;2;


//Corridors
room;1;4;
color;0;0;80;

room;3;4;
color;0;0;80;

room;6;4;
color;0;0;80;

map;
........... ........... ........... ........... ........... ........... ........... ........... ........... 
........... ........... ........... ........... ........... ........... ........... ........... ........... 
........... ........... ........... ........... ........... ........... ........... ........... ........... 
........... ........... ........... ........... ........... ........... ........... ........... ........... 
........... ........... ........... ........... ........... ........... ........... ........... ........... 
........... ........... ........... ...........O...........O...........O........... ........... ........... 
........... ........... ........... ........... ........... ........... ........... ........... ........... 
........... ........... ........... ........... ........... ........... ........... ........... ........... 
........... ........... ........... ........... ........... ........... ........... ........... ........... 
........... ........... ........... ........... ........... ........... ........... ........... ........... 
........... ........... ........... ........... ........... ........... ........... ........... ........... 
                                                                 O                                          
........... ........... ........... ........... ........... ........... ........... ........... ........... 
........... ........... ........... ........... ........... ........... ........... ........... ........... 
........... ........... ........... ........... ........... ........... ........... ........... ........... 
........... ........... ........... ........... ........... ........... ........... ........... ........... 
........... ........... ........... ........... ........... ........... ........... ........... ........... 
........... ........... ........... ........... ........... ........... ........... ........... ........... 
........... ........... ........... ........... ........... ........... ........... ........... ........... 
........... ........... ........... ........... ........... ........... ........... ........... ........... 
........... ........... ........... ........... ........... ........... ........... ........... ........... 
........... ........... ........... ........... ........... ........... ........... ........... ........... 
........... ........... ........... ........... ........... ........... ........... ........... ........... 
                                                                 O                                          
........... ........... ........... ........... ........... ........... ........... ........... ........... 
........... ........... ........... ........... ........... ........... ........... ........... ........... 
........... ........... ........... ........... ........... ........... ........... ........... ........... 
........... ........... ........... ........... ........... ........... ........... ........... ........... 
........... ........... ........... ........... ........... ........... ........... ........... ........... 
...........O...........O........... ........... ...........O........... ........... ........... ........... 
........... ........... ........... ........... ........... ........... ........... ........... ........... 
........... ........... ........... ........... ........... ........... ........... ........... ........... 
........... ........... ........... ........... ........... ........... ........... ........... ........... 
........... ........... ........... ........... ........... ........... ........... ........... ........... 
........... ........... ........... ........... ........... ........... ........... ........... ........... 
     O                       O                       O                                                      
........... ........... ........... ........... ........... ........... ........... ........... ........... 
........... ........... ........... ........... ........... ........... ........... ........... ........... 
........... ........... ........... ........... ........... ........... ........... ........... ........... 
........... ........... ........... ........... ........... ........... ........... ........... ........... 
........... ........... ........... ........... ........... ........... ........... ........... ........... 
........... ........... ........... ........... ........... ........... ........... ........... ........... 
........... ........... ........... ........... ........... ........... ........... ........... ........... 
........... ........... ........... ........... ........... ........... ........... ........... ........... 
........... ........... ........... ........... ........... ........... ........... ........... ........... 
........... ........... ........... ........... ........... ........... ........... ........... ........... 
........... ........... ........... ........... ........... ........... ........... ........... ........... 
     O                       O                       O                                          8 4         
........... ........... ........... ........... ........... ........... ........... ........... ...B....... 
........... ........... ........... ........... ........... ........... ........... ........... ........... 
........... ........... ........... ........... ........... ........... ........... ........... ........... 
........... ........... ........... ........... ........... ........... ........... ........... ........... 
........... ........... ........... ........... ........... ........... ........... ........... ........... 
...........O...........O...........O...........O...........O...........O........... ...........X........... 
........... ........... ........... ........... ........... ........... ........... ........... .....F..... 
........... ........... ........... ........... ........... ........... ........... ........... ........... 
........... ........... ........... ........... ........... ........... ........... ........... ..t.....t.. 
........... ........... ........... ........... ........... ........... ........... ........... .o.oo.oo.o. 
........... ........... ........... ........... ........... ........... ........... ........... ....o.o.... 
                             O                       O                                          8 5  X      
........... ........... ........... ........... ........... ........... ........... ........... ooot....... 
........... ........... ........... ........... ........... ........... ........... ........... ooo.......k 
........... ........... ........... ........... ........... ........... ........... ........... ooot.p...oo 
........... ........... ........... ........... ........... ........... ........... ........... ooo........ 
........... ........... ........... ........... ........... ........... ........... ........... ooot....... 
........... ........... ........... ........... ........... ........... ........... ........... oooo......o 
........... ........... ........... ........... ........... ........... ........... ........... ...o......o 
........... ........... ........... ........... ........... ........... ........... ........... ...oooooo.o 
........... ........... ........... ........... ........... ........... ........... ........... .x.t......t 
........... ........... ........... ........... ........... ........... ........... ........... ....ooo.... 
........... ........... ........... ........... ........... ........... ........... ........... ......ott.. 
                             O                       X      5 6         6 6                     8 6  O      
........... ........... ........... ........... ....e.e.... ....t...... ...o.....y. ........... A.........B 
........... ........... ........... ........... ..k.eee.... ........... .o.oo..ooyo ........... .C.......C. 
........... ........... ........... ........... tc......... ........... .o.o.o.oo.. ........... A.........B 
........... ........... ........... ........... b.......... ...p.....t. .o..y..oo.. ........... ........... 
........... ........... ........... ........... tc......... ........... .ooo.ooooo. ........... A.........B 
........... ...........O...........O...........X.o.........X...........O.o...o...o. ........... ........... 
........... ........... ........... ........... oo......... ........... ...ooooo... ........... A.........B 
........... ........... ........... ........... ........... .t......... ..o....o.oo ........... ........... 
........... ........... ........... ........... ...c.x.c... ........... xoo.oo.o.o. ........... A.........B 
........... ........... ........... ........... ........... ........... .o..o....o. ........... ...ooooo... 
........... ........... ........... ........... ........... ......t.... k..oo.oo... ........... ........... 
                 O                                   O                  6 7  X                       X      
........... ........... ........... ........... .o.o....ooo ........... ....o.ot... ....o...... ........ooo 
........... ........... ........... ........... o.....o.oo. ........... ....oxo.... ....b...... .t......ooo 
........... ........... ........... ........... ooo....oo.. ........... ........... ....oooooo. A.......ooo 
........... ........... ........... ........... oooo....o.. ........... ..........t ....o....o. .x......ooo 
........... ........... ........... ........... H..oo.....o ........... ...t..o..oo ....obb..o. .k......ooo 
........... ........... ........... ........... o..oo....oo ........... ....o....o.O..H.okbx.b. .....t.tooo 
........... ........... ........... ........... oo.x......o ........... ....t....o. ....obb..o. oooooo..... 
........... ........... ........... ........... oo.oo...... ........... .........o. ....o..p.o. A.......... 
........... ........... ........... ........... ...oo..o... ........... t.......... ....oooooo. b.......... 
........... ........... ........... ........... Pooo..ooo.. ........... ....obo.... ....b...... ..........B 
........... ........... ........... ........... oo.oo.oo... ........... ....o.o.... ....o...... a.....ooooo 
                                                     X                  6 8  O                       X      
........... ........... ........... ........... ........... ........... .o.......o. oo.......oo ....e.e.... 
........... ........... ........... ........... ........... ........... .b.......o. oo...o...oo ....e.e..t. 
........... ........... ........... ........... ........... ........... .oA.....oo. ..x..o..x.. t.....e...D 
........... ........... ........... ........... ........... ........... .oo.....Bo. ........... ..t.eEet... 
........... ........... ........... ........... ........... ........... .oA.....oo. .....t..... eeeeeeeeeee 
........... ........... ........... ........... ........... ........... .oo..k..Bo.X.oootktooo.X..........A 
........... ........... ........... ........... ........... ........... .....C..... .....t..... eeeeeeeeeee 
........... ........... ........... ........... ........... ........... .o..o..o.oo ........... ....e.e.... 
........... ........... ........... ........... ........... ........... .o..o.xo.o. ..x..o..x.. t...e.et... 
........... ........... ........... ........... ........... ........... .o..o..o.o. oo...o...oo ..tBe.e..tC 
........... ........... ........... ........... ........... ........... ..D.....Do. oo.......oo ...ke.x.... 
                                                                                                            