worldSize;9;9;

//Final
room;4;8;
color;0;0;0;
goalDoor;2;

//Starting
room;4;7;
color;0;0;0;
goalDoor;2;
colorLock;2;255;0;0;
H;H;0;
h;H;1;
P;P;
o;B;0;0;0;0;
x;B;0;0;0;1;

//Crossways
room;4;6;
color;0;0;0;
goalDoor;1;
o;B;0;0;0;0;
c;B;0;0;0;1;
x;B;50;50;150;1;
b;B;0;0;0;2;
e;E;1;1;
k;K;50;50;150;1;
t;T;

//Start Blue Rooms
room;5;6;
color;0;0;80;
goalDoor;1;
t;T;
p;p;

room;6;6;
color;0;0;80;
goalDoor;3;
k;K;0;0;100;3;
x;B;0;0;100;1;
o;B;0;0;0;0;

room;6;7;
color;0;0;80;
goalDoor;3;
o;B;0;0;0;0;
b;B;0;0;100;2;
t;T;

room;7;7;
color;0;0;120;
goalDoor;1;
//lockOnEnter;
H;H;1;
o;B;0;0;100;0;
b;B;0;0;80;2;
k;K;0;0;100;0;
x;B;0;0;100;1;
p;p;

room;6;8;
color;0;0;80;
goalDoor;1;
o;B;0;0;100;0;
b;B;0;0;0;2;
T;A;
x;B;0;0;100;1;
k;K;0;0;100;1;

room;7;8;
color;0;0;80;
goalDoor;1;
o;B;0;0;100;0;
x;B;0;0;0;1;
k;K;0;0;100;1;
t;T;

room;8;8;
color;0;0;80;
goalDoor;2;
e;E;
t;T;
x;B;0;0;80;1;
k;K;0;0;80;2;
p;p;
A;t;1;5;
B;t;6;5;
C;t;6;0;
D;t;2;0;
E;t;5;5;

room;8;7;
color;0;0;80;
goalDoor;4;

room;8;6;
color;0;0;80;
goalDoor;2;

room;8;5;
color;0;0;80;
goalDoor;2;

//Blue Boss
room;8;4;
color;0;0;80;
goalDoor;0;
o;B;0;0;150;0;
F;F;
t;T;
B;X;
a;H;0;
b;H;1;

room;7;4;
color;0;0;80;
goalDoor;2;


//Corridors
room;1;4;
color;0;0;80;

room;3;4;
color;0;0;80;

room;6;4;
color;0;0;80;

map;
........... ........... ........... ........... ........... ........... ........... ........... ........... 
........... ........... ........... ........... ........... ........... ........... ........... ........... 
........... ........... ........... ........... ........... ........... ........... ........... ........... 
........... ........... ........... ........... ........... ........... ........... ........... ........... 
........... ........... ........... ........... ........... ........... ........... ........... ........... 
........... ........... ........... ...........O...........O...........O........... ........... ........... 
........... ........... ........... ........... ........... ........... ........... ........... ........... 
........... ........... ........... ........... ........... ........... ........... ........... ........... 
........... ........... ........... ........... ........... ........... ........... ........... ........... 
........... ........... ........... ........... ........... ........... ........... ........... ........... 
........... ........... ........... ........... ........... ........... ........... ........... ........... 
                                                                 O                                          
........... ........... ........... ........... ........... ........... ........... ........... ........... 
........... ........... ........... ........... ........... ........... ........... ........... ........... 
........... ........... ........... ........... ........... ........... ........... ........... ........... 
........... ........... ........... ........... ........... ........... ........... ........... ........... 
........... ........... ........... ........... ........... ........... ........... ........... ........... 
........... ........... ........... ........... ........... ........... ........... ........... ........... 
........... ........... ........... ........... ........... ........... ........... ........... ........... 
........... ........... ........... ........... ........... ........... ........... ........... ........... 
........... ........... ........... ........... ........... ........... ........... ........... ........... 
........... ........... ........... ........... ........... ........... ........... ........... ........... 
........... ........... ........... ........... ........... ........... ........... ........... ........... 
                                                                 O                                          
........... ........... ........... ........... ........... ........... ........... ........... ........... 
........... ........... ........... ........... ........... ........... ........... ........... ........... 
........... ........... ........... ........... ........... ........... ........... ........... ........... 
........... ........... ........... ........... ........... ........... ........... ........... ........... 
........... ........... ........... ........... ........... ........... ........... ........... ........... 
...........O...........O........... ........... ...........O........... ........... ........... ........... 
........... ........... ........... ........... ........... ........... ........... ........... ........... 
........... ........... ........... ........... ........... ........... ........... ........... ........... 
........... ........... ........... ........... ........... ........... ........... ........... ........... 
........... ........... ........... ........... ........... ........... ........... ........... ........... 
........... ........... ........... ........... ........... ........... ........... ........... ........... 
     O                       O                       O                                                      
........... ........... ........... ........... ........... ........... ........... ........... ........... 
........... ........... ........... ........... ........... ........... ........... ........... ........... 
........... ........... ........... ........... ........... ........... ........... ........... ........... 
........... ........... ........... ........... ........... ........... ........... ........... ........... 
........... ........... ........... ........... ........... ........... ........... ........... ........... 
........... ........... ........... ........... ........... ........... ........... ........... ........... 
........... ........... ........... ........... ........... ........... ........... ........... ........... 
........... ........... ........... ........... ........... ........... ........... ........... ........... 
........... ........... ........... ........... ........... ........... ........... ........... ........... 
........... ........... ........... ........... ........... ........... ........... ........... ........... 
........... ........... ........... ........... ........... ........... ........... ........... ........... 
     O                       O                       O                                                      
........... ........... ........... ........... ........... ........... ........... ........... ...B....... 
........... ........... ........... ........... ........... ........... ........... ........... ........... 
........... ........... ........... ........... ........... ........... ........... ........... ........... 
........... ........... ........... ........... ........... ........... ........... ........... ........... 
........... ........... ........... ........... ........... ........... ........... ........... ........... 
...........O...........O...........O...........O...........O...........O...........O...........Xt.........t 
........... ........... ........... ........... ........... ........... ........... ........... .....F..... 
........... ........... ........... ........... ........... ........... ........... ........... ........... 
........... ........... ........... ........... ........... ........... ........... ........... ..t.....t.. 
........... ........... ........... ........... ........... ........... ........... ........... ooooo.ooooo 
........... ........... ........... ........... ........... ........... ........... ........... ....o.o.... 
                             O                       O                                               O      
........... ........... ........... ........... ........... ........... ........... ........... ........... 
........... ........... ........... ........... ........... ........... ........... ........... ........... 
........... ........... ........... ........... ........... ........... ........... ........... ........... 
........... ........... ........... ........... ........... ........... ........... ........... ........... 
........... ........... ........... ........... ........... ........... ........... ........... ........... 
........... ........... ........... ........... ........... ........... ........... ........... ........... 
........... ........... ........... ........... ........... ........... ........... ........... ........... 
........... ........... ........... ........... ........... ........... ........... ........... ........... 
........... ........... ........... ........... ........... ........... ........... ........... ........... 
........... ........... ........... ........... ........... ........... ........... ........... ........... 
........... ........... ........... ........... ........... ........... ........... ........... ........... 
                             O                       X                                               O      
........... ........... ........... ........... ....e.e.... ....t...... ...o.....x. ........... ........... 
........... ........... ........... ........... ..k.eee.... ........... .o.oo..ooxo ........... ........... 
........... ........... ........... ........... t.......... ........... .o.o.o.oo.. ........... ........... 
........... ........... ........... ........... b.......... ...p.....t. .o..x..oo.. ........... ........... 
........... ........... ........... ........... t.......... ........... .ooo.ooooo. ........... ........... 
........... ...........O...........O...........X.o.........X...........O.o...o...o. ........... ........... 
........... ........... ........... ........... oo......... ........... ...ooooo... ........... ........... 
........... ........... ........... ........... ........... .t.....p... ..o....o.oo ........... ........... 
........... ........... ........... ........... ...c.x.c... ........... xoo.oo.o.o. ........... ........... 
........... ........... ........... ........... ...t....... ........... .o..o....o. ........... ........... 
........... ........... ........... ........... ........... ......t.... k..oo.oo... ........... ........... 
                 O                                   O                       X                       O      
........... ........... ........... ........... .o.o....ooo ........... ....o.o.... ....o...... ........... 
........... ........... ........... ........... o.....o.oo. ........... ....o.o.t.. ....b...... ........... 
........... ........... ........... ........... ooo....oo.. ........... .........t. ....oooooo. ........... 
........... ........... ........... ........... oooo....o.. ........... ........... ....o....o. ........... 
........... ........... ........... ........... H..oo.....o ........... ...t.....oo ....obb..o. ........... 
........... ........... ........... ........... o..oo.h..oo ........... .........o.O..H.okbx.b. ........... 
........... ........... ........... ........... oo.x......o ........... .........o. ....obb..o. ........... 
........... ........... ........... ........... oo.oo...... ........... ....t.t..o. ....o..p.o. ........... 
........... ........... ........... ........... ...oo..o... ........... t.......... ....oooooo. ........... 
........... ........... ........... ........... Pooo..ooo.. ........... ....obo.... ....b...... ........... 
........... ........... ........... ........... oo.oo.oo... ........... ....o.o.... ....o...... ........... 
                                                     X                       O                       X      
........... ........... ........... ........... ........... ........... .o.......o. oo.......oo ....e.e.... 
........... ........... ........... ........... ........... ........... .b......To. oo...o...oo ....e.e..t. 
........... ........... ........... ........... ........... ........... .oT.....oo. ..x..o..x.. ......e...D 
........... ........... ........... ........... ........... ........... .oo.....To. ........... ....eEet... 
........... ........... ........... ........... ........... ........... .oT.....oo. .....t..... eeeeeeeeeee 
........... ........... ........... ........... ........... ........... .oo..k..To.X.oootktooo.X..........A 
........... ........... ........... ........... ........... ........... .....T..... .....t..... eeeeeeeeeee 
........... ........... ........... ........... ........... ........... .o..o..o.oo ........... ....e.e.... 
........... ........... ........... ........... ........... ........... .o..o.xo.o. ..x..o..x.. ..p.e.e.... 
........... ........... ........... ........... ........... ........... .o..o..o.o. oo...o...oo ...Be.e...C 
........... ........... ........... ........... ........... ........... ..T.....To. oo.......oo ...ke.x.... 
                                                                                                            